XXXXXXXXXXXXXXXXXXXXXXXXXXXXXXXXXXXXXXXXXXXXXXXXXXXXXXXXXXXXXXXXXXXXXXXXXXXXXXXXX
X   X                       X           X   X           X               X       X
X   X   X   XXXXXXXXXXXXX   XXXXX   X   X   X   XXXXX   XXXXXXXXXXXXX   X   X   X
X   X   X           X   X   X       X       X       X   X               X   X   X
X   X   X   XXXXX   X   X   X   XXXXXXXXXXXXXXXXX   X   X   XXXXXXXXXXXXX   XXXXX
X   X   X       X   X   X       X                   X       X                   X
X   XXXXXXXXXXXXX   X   XXXXX   X   XXXXXXXXXXXXX   XXXXXXXXXXXXXXXXX   XXXXX   X
X                   X       X   X       X       X   X               X       X   X
X   XXXXX   XXXXXXXXXXXXX   XXXXXXXXX   X   X   X   X   XXXXXXXXX   X   XXXXX   X
X   X   X   X   X       X       X   X       X   X       X           X   X       X
X   X   X   X   XXXXX   XXXXX   X   XXXXXXXXX   XXXXXXXXX   XXXXXXXXXXXXX   XXXXX
X       X   X       X           X   X           X                           X   X
XXXXXXXXX   X   XXXXX   X   XXXXX   X   XXXXXXXXXXXXXXXXXXXXXXXXXXXXXXXXXXXXX   X
X       X   X       X   X       X   X                                   X       X
X   X   X   XXXXX   X   X   X   X   XXXXXXXXX   XXXXX   XXXXXXXXXXXXX   X   XXXXX
X   X   X       X       X   X   X           X       X       X           X       X
XXXXX   XXXXX   XXXXXXXXX   X   X   X   XXXXXXXXX   XXXXXXXXXXXXX   XXXXXXXXX   X
X           X       X       X   X   X   X           X               X           X
X   X   XXXXXXXXX   XXXXX   X   X   XXXXX   X   XXXXX   XXXXXXXXXXXXX   XXXXX   X
X   X   X       X           X   X       X   X   X       X               X       X
X   XXXXX   X   XXXXX   XXXXX   X   X   X   X   X   XXXXX   XXXXXXXXXXXXX   XXXXX
X       X   X   X   X   X   X   X   X       X   X   X       X       X           X
X   X   X   X   X   X   X   XXXXX   XXXXXXXXXXXXX   X   X   X   XXXXXXXXXXXXX   X
X   X       X   X   X   X           X   X       X       X   X           X   X   X
X   XXXXXXXXX   X   X   XXXXXXXXXXXXX   X   X   X   XXXXXXXXXXXXXXXXX   X   X   X
X   X           X       X       X           X       X                   X   X   X
X   X   XXXXX   X   XXXXX   X   X   X   XXXXXXXXXXXXX   XXXXXXXXXXXXXXXXX   X   X
X   X       X   X   X       X       X   X               X       X           X   X
XXXXXXXXX   XXXXX   X   XXXXXXXXX   XXXXX   XXXXXXXXXXXXX   XXXXX   XXXXX   X   X
X       X       X   X       X   X           X           X       X       X   X   X
X   X   XXXXX   X   X   X   X   XXXXXXXXXXXXXXXXXXXXX   X   X   XXXXX   X   X   X
X   X       X           X               X               X   X           X       X
XXXXX   X   XXXXX   XXXXXXXXX   XXXXX   XXXXX   XXXXXXXXX   XXXXXXXXXXXXXXXXXXXXX
X   X   X   X       X   X   X       X       X           X                       X
X   XXXXX   X   XXXXX   X   XXXXX   XXXXX   XXXXXXXXX   XXXXXXXXXXXXXXXXXXXXX   X
X   X           X       X       X       X   X       X           X           X   X
X   X   XXXXXXXXX   X   X   X   XXXXX   X   X   X   X   X   XXXXX   XXXXX   X   X
X   X       X       X   X   X   X   X   X   X   X   X   X   X       X       X   X
X   XXXXX   XXXXXXXXX   X   XXXXX   XXXXX   X   XXXXX   XXXXX   XXXXX   XXXXX   X
X                                       X       X                   X           X
XXXXXXXXXXXXXXXXXXXXXXXXXXXXXXXXXXXXXXXXXXXXXXXXXXXXXXXXXXXXXXXXXXXXXXXXXXXXXXXXX

