XXXXXXXXXXXXXXXXXXXXXXXXXXXXXXXXXXXXXXXXXXXXXXXXXXXXXXXXXXXXXXXXXXXXXXXXXXXXXXXXX
X   X                   X       X       X                   X           X       X
X   XXXXX   XXXXX   XXXXX   XXXXX   X   X   XXXXXXXXXXXXX   X   X   X   X   X   X
X   X       X   X   X               X   X       X       X   X   X   X       X   X
X   X   XXXXX   X   XXXXXXXXXXXXX   X   XXXXX   X   X   X   X   X   XXXXXXXXXXXXX
X       X                           X       X   X   X       X   X       X       X
XXXXXXXXX   X   XXXXXXXXXXXXXXXXXXXXX   X   X   X   XXXXXXXXXXXXXXXXX   X   X   X
X       X   X       X       X           X       X   X       X       X   X   X   X
X   X   X   XXXXX   X   X   X   XXXXXXXXXXXXX   X   X   X   XXXXX   X   X   X   X
X   X       X       X   X   X       X       X   X   X   X           X       X   X
X   XXXXXXXXX   XXXXXXXXX   XXXXXXXXX   X   X   XXXXX   XXXXXXXXXXXXXXXXXXXXX   X
X   X       X               X           X   X       X           X           X   X
X   X   XXXXX   XXXXXXXXXXXXX   XXXXXXXXX   XXXXX   XXXXXXXXX   X   XXXXX   X   X
X   X           X   X           X       X       X               X   X       X   X
X   XXXXXXXXX   X   X   XXXXXXXXXXXXX   XXXXX   XXXXXXXXXXXXX   X   X   XXXXX   X
X       X           X   X                   X               X       X           X
XXXXX   X   XXXXXXXXX   X   XXXXX   XXXXXXXXXXXXXXXXXXXXX   XXXXXXXXXXXXXXXXX   X
X   X   X           X   X   X   X           X           X   X   X               X
X   X   X   XXXXX   X   XXXXX   XXXXXXXXX   X   X   XXXXXXXXX   X   X   XXXXXXXXX
X       X       X   X           X       X       X           X       X           X
X   X   XXXXXXXXX   X   XXXXXXXXX   XXXXX   XXXXXXXXXXXXX   X   XXXXXXXXXXXXX   X
X   X   X           X       X   X           X               X           X       X
X   XXXXX   XXXXXXXXXXXXX   X   XXXXXXXXXXXXX   X   XXXXXXXXXXXXX   XXXXX   XXXXX
X   X   X                   X                   X   X       X       X       X   X
X   X   XXXXX   XXXXXXXXXXXXX   XXXXXXXXXXXXXXXXX   X   X   XXXXXXXXX   XXXXX   X
X       X       X       X       X           X       X   X   X       X       X   X
XXXXXXXXX   XXXXX   X   X   XXXXX   X   XXXXX   X   X   X   X   X   XXXXX   X   X
X       X   X       X   X       X   X   X       X       X       X           X   X
XXXXX   XXXXX   X   XXXXXXXXX   XXXXX   X   XXXXXXXXXXXXXXXXXXXXXXXXXXXXX   X   X
X       X       X   X       X       X       X                           X       X
X   XXXXX   X   XXXXX   X   XXXXX   X   XXXXXXXXXXXXXXXXXXXXXXXXXXXXX   XXXXX   X
X       X   X           X   X       X   X           X       X   X           X   X
X   X   X   XXXXXXXXXXXXX   X   XXXXX   X   XXXXX   X   X   X   X   XXXXXXXXX   X
X   X       X           X   X   X       X   X   X       X   X   X               X
X   XXXXXXXXX   XXXXXXXXX   X   XXXXXXXXX   X   XXXXXXXXX   X   XXXXXXXXXXXXXXXXX
X   X                   X   X               X           X       X           X   X
X   X   XXXXXXXXXXXXX   X   XXXXXXXXXXXXXXXXX   XXXXXXXXXXXXX   XXXXX   X   X   X
X   X   X       X       X   X           X           X       X       X   X       X
X   XXXXX   X   X   X   X   X   X   XXXXX   XXXXX   X   X   XXXXX   X   XXXXX   X
X           X       X   X       X               X       X               X       X
XXXXXXXXXXXXXXXXXXXXXXXXXXXXXXXXXXXXXXXXXXXXXXXXXXXXXXXXXXXXXXXXXXXXXXXXXXXXXXXXX

