XXXXXXXXXXXXXXXXXXXXXXXXXXXXXXXXXXXXXXXXXXXXXXXXXXXXXXXXXXXXXXXXXXXXXXXXXXXXXXXXXXXXXXXXXXXXXXXXXXXXX
X       X       X               X                                   X                   X           X
X   XXXXXXXXX   XXXXX   X   XXXXX   XXXXXXXXXXXXXXXXX   XXXXX   X   X   XXXXX   XXXXXXXXXXXXXXXXX   X
X           X           X           X               X   X       X   X   X       X               X   X
X   XXXXX   XXXXXXXXX   XXXXXXXXXXXXX   XXXXXXXXX   X   X   XXXXX   XXXXX   XXXXX   XXXXXXXXX   X   X
X   X               X       X       X   X       X   X   X       X   X       X               X       X
X   X   XXXXXXXXX   XXXXXXXXX   XXXXX   XXXXX   X   XXXXXXXXX   X   X   XXXXX   XXXXXXXXX   XXXXX   X
X   X   X   X               X       X       X                   X       X       X       X       X   X
XXXXX   X   X   XXXXXXXXX   XXXXX   XXXXX   XXXXXXXXXXXXXXXXX   XXXXXXXXX   XXXXXXXXX   XXXXX   X   X
X           X   X           X       X   X               X               X   X               X   X   X
X   XXXXX   XXXXXXXXXXXXXXXXX   XXXXX   XXXXXXXXX   X   XXXXXXXXXXXXX   X   X   X   XXXXXXXXX   X   X
X       X   X           X               X       X   X               X   X   X   X   X           X   X
XXXXX   X   X   XXXXX   XXXXXXXXXXXXX   X   XXXXX   XXXXXXXXXXXXXXXXX   X   XXXXX   X   XXXXXXXXXXXXX
X       X       X   X   X               X       X       X       X       X           X               X
X   XXXXXXXXXXXXX   X   X   X   XXXXXXXXX   X   X   X   X   X   X   XXXXXXXXXXXXX   XXXXXXXXXXXXX   X
X       X           X       X   X           X       X       X   X       X           X           X   X
XXXXX   X   XXXXXXXXXXXXXXXXX   X   XXXXXXXXX   XXXXXXXXXXXXX   XXXXX   X   XXXXXXXXX   X   XXXXX   X
X   X   X                           X       X   X           X   X       X   X           X   X       X
X   X   XXXXXXXXXXXXX   XXXXXXXXXXXXXXXXX   XXXXX   X   XXXXX   X   XXXXX   XXXXXXXXXXXXX   X   X   X
X   X       X       X   X       X       X       X   X           X       X                   X   X   X
X   XXXXX   X   X   XXXXX   X   X   X   X   X   X   XXXXXXXXXXXXXXXXX   X   XXXXXXXXXXXXXXXXX   X   X
X       X   X   X           X       X       X   X   X                   X   X           X       X   X
X   XXXXX   X   XXXXXXXXX   XXXXX   XXXXXXXXX   XXXXX   XXXXXXXXXXXXXXXXXXXXX   XXXXX   X   XXXXX   X
X           X       X       X               X       X   X                       X           X       X
X   XXXXXXXXX   X   XXXXXXXXX   XXXXXXXXX   XXXXX   X   XXXXX   XXXXXXXXX   XXXXXXXXXXXXXXXXX   XXXXX
X   X       X   X           X   X           X       X       X       X       X           X   X   X   X
X   X   X   XXXXXXXXXXXXX   X   XXXXXXXXXXXXX   XXXXXXXXX   XXXXX   X   XXXXX   XXXXX   X   X   X   X
X       X                   X           X   X   X       X   X       X               X   X       X   X
XXXXXXXXXXXXXXXXX   XXXXXXXXXXXXXXXXX   X   XXXXX   X   X   XXXXXXXXX   XXXXXXXXXXXXX   X   XXXXX   X
X   X               X           X   X       X       X   X           X   X               X       X   X
X   X   XXXXXXXXXXXXX   XXXXX   X   XXXXXXXXX   XXXXX   XXXXXXXXX   X   X   XXXXXXXXXXXXXXXXX   X   X
X   X       X               X   X           X       X   X           X   X               X   X       X
X   XXXXX   XXXXX   X   X   X   XXXXX   X   X   XXXXX   X   XXXXXXXXXXXXXXXXXXXXXXXXX   X   XXXXX   X
X       X       X   X   X   X           X   X   X       X       X           X       X   X           X
X   XXXXXXXXX   XXXXX   X   XXXXXXXXXXXXX   X   X   XXXXXXXXX   X   XXXXX   X   X   X   XXXXXXXXX   X
X               X       X   X               X   X       X   X       X   X   X   X       X       X   X
X   XXXXXXXXXXXXX   XXXXX   X   XXXXXXXXXXXXX   X   XXXXX   XXXXXXXXX   XXXXX   XXXXX   X   X   XXXXX
X               X   X       X   X           X   X                               X   X   X   X       X
XXXXX   XXXXXXXXX   X   XXXXX   X   X   X   XXXXXXXXX   XXXXXXXXX   XXXXXXXXXXXXX   X   X   XXXXX   X
X   X               X       X       X   X   X           X       X   X               X   X   X   X   X
X   XXXXXXXXXXXXXXXXXXXXX   XXXXXXXXX   X   X   XXXXXXXXX   X   XXXXX   XXXXX   XXXXXXXXX   X   X   X
X               X       X   X       X   X       X   X       X   X       X   X   X   X       X   X   X
X   X   X   XXXXX   X   X   X   X   X   XXXXXXXXX   X   XXXXX   X   X   X   X   X   X   XXXXX   X   X
X   X   X   X       X       X   X                   X   X           X       X       X       X   X   X
X   X   X   X   XXXXXXXXXXXXXXXXXXXXXXXXX   XXXXXXXXX   XXXXXXXXXXXXXXXXXXXXX   XXXXXXXXX   X   X   X
X   X   X   X       X               X       X       X           X           X               X   X   X
X   X   XXXXXXXXX   XXXXXXXXX   X   X   XXXXX   X   XXXXXXXXX   X   XXXXX   XXXXXXXXXXXXXXXXX   X   X
X   X   X                       X   X       X   X           X   X       X   X                   X   X
X   X   X   XXXXXXXXXXXXXXXXXXXXX   XXXXXXXXX   XXXXXXXXX   X   XXXXX   X   X   XXXXXXXXXXXXX   X   X
X   X                           X               X               X       X       X                   X
XXXXXXXXXXXXXXXXXXXXXXXXXXXXXXXXXXXXXXXXXXXXXXXXXXXXXXXXXXXXXXXXXXXXXXXXXXXXXXXXXXXXXXXXXXXXXXXXXXXXX

